11111111111111111111111
1CC00000000000100000011
1C0000000000000P000C001
1110110000111100C000001
1E001000001111000011001
11111111111111111111111