11111111111111111111111
1C000000000000100000011
1000000000000000000C001
1101110000111100C000001
1E000000001111000011001
1111111100011100P011001
10000000000001000000001
10C00000000001000000111
11011100001111000001101
10000000000C00000001001
11111111111111111111111