111111111
100000001
100000001
1000PCE01
111111111